111111111111
1P0C00S000E1
1C0C0C000001
111111111111